1111111111111111111111111
1E0000000000000C00000C001
111101010010P000101001001
1100010010101010001001001
100000000C00C000000000001
1111111111111111111111111
