1111111111111111111111111
1E0000000000000C00000C0X1
1111010100100X00101001001
1100010010101010001001001
100P10000C00C00000X000001
1111111111111111111111111
