11111111111
10000100001
1C100001001
100E00000C1
11111111111
