111111111
100000001
1C0C00CC1
10E000011
1P00X0001
111111111
