11111111111
1000P100001
1C100001001
100E00000C1
11111111111
