1111111111111111111111111
1E0000000000000C00000C001
1111010100100000101001001
1100010010101010001001001
100P10000C00C000000000001
1111111111111111111111111
